111111
1P0CE1
10B001
111111