1111111111111111111111111111111111
1E1000P00000000C00000C000000000001
1010010100100000100001000000010101
1010010010101010000001000000010101
100000000C00C0000B0000000B000000C1
1111111111111111111111111111111111
