1111111111111111111111111111111111
1E1000P00000000C00000000000000C001
1010010100100000100001000000010101
1010010010101010000001000000010101
100000000000C000000000000000000001
1111111111111111111111111111111111